NO textures/north.png

EA          textures/east.png
SO textures/south.png
F 220,100,0

C       0,0,255
WE textures/west.png

11111111111111              1111111111111111
1 000000000 01              1 0 00 0  0 00 1
10000000000001111111        1 00 0 0 0 0 0 1
1000000000      0001        10 00 0 0 00 0 1
100000H0000001111111        10 00 0 0 0 0 01
1 000HNH000001111111111111111            111
100000H000000000000000000000000000000000001
1X000000 00000000000000000000000000000000011
100000000000011111111111111111111111       11
10000111111000000001               1        11
1 000100000001  11111111           1         1
10000100000001 1 11111111         11         1
100001000000X1111110              11         1
100001 000000000011                1        11
100001111111000011                 11111111111
10000000000001111
11111111111111

