11111111111111
1e000000000e01
10000000000001
1000N000000001
10000000000001
10000000000001
10000000000001
10000000e00001
10000000000001
10000000000001
1e000000000001
11111111111111