NO textures/woo1d.png     

EA          textures/mossy.png    
SO textures/pillar.png
F 220,100,0

C 200,200,200
WE textures/greystone.png
11111111111111              1111111111111111
1X000000000X01              1 0 00 0  0 00 1
10000000000001111111        1 00 0 0 0 0 0 1
1000N00000      0001        10 00 0 0X00 0 1
10000000000001111111        10 00 0 0 0 0 01
1X000000000001111111111111111            111
1000000000000000000000000000000000000000001
1X000000X00000000000000000000000000000000011
100000000000011111111111111111111111       11
10000111111000000001               1        11
1X000100000001  11111111           1         1
10000100000001 1 11111111         11         1
100001000000X1111110              11         1
100001X000000000011                1        11
100001111111000011                 11111111111
10000000000001111
11111111111111