NO textures/wall_no.png     
EA textures/wall_ea.png    
SO textures/wall_so.png
F 161,133,148
C 127,181,181
WE textures/wall_we.png

1111111111111111111111111111111111111111111111111111111111111111111111111111111111111
1       11      111            H      S    H     X              X   111111111   11  1
1       11      111      X     111111111111111111        111                        1
1               111            1                1      X       1                    1
1        X                     1      11111                    11111111111111       1
1     11111111111H11111111111111111111111111111111111111       1                11  1
1                    1                               11        1   1    11111  11   1
1     1111   11      1       11111111111111                    1                    1
1     1111   11      1                            1111         1       111111  11   1
1     1111           1     1     11111111111111111111111111111111111H11111111  11   1
111H111111111111111111     1    11                              1      1    111111111
1                          1            11                  1   1      1            1
1     11111111111111111111111111111111111111111111111111    1   1      1            1
1             1              1111                           1   1           111111  1
1             H              1111            1              1   1      1            1
1             1                              1              1          1            1
111111111111111       11111111111H1111111111111111111111111111H111111111            1
1     11      1       11   1            11       11                        11       1
1     11      1       1   11                11                      1      11       1
1                     11   1       11111111111111H111111111      111111111111       11
1      1111111111    1    1                              1      1       1111        11
1                     1   11     11111111111111           1      1                  1
1                     11   H     1           1     111    1      1  1   11      1   1
1 1111111111          1   11     1 11  11    1     111    1      1  1   11      1   1
111                   1    111   1           1            1      1  1           1   1
1 11                  1   111          1     1   1               1          11111   1
1         111111111H111              111     H   1      111      1                  1
1   11          1     111111111111111111111111   1      111      1111H1111111       1
1   11          1               11               1      111            111          1
1               1                                1              11            1     1
1111111111111111111111111111111111111111111111111111111111111111111111111111111111111