NO textures/woo1d.png     

EA          textures/mossy.png    
SO textures/pillar.png
F 220,100,0

C 225,30,100 
WE textures/greystone.png

11111111111
100H0000001
10010000001
111111111H1
10000000001
1111H111111
100X0000001
10000N00001
11000001111
11111111111