NO textures/wall_no.png     
EA textures/wall_ea.png    
SO textures/wall_so.png
F 161,133,148
C 127,181,181
WE textures/wall_we.png

1111111111111111111111111111111111111111111111111111111111111111111111111111111111111
1       11      111            1     S     H                        111111111   11  1
1       11      111        X   111111111111111111        111            X           1
1    X          111       X    1                1 X            1                    1
1            X                 1  X   11111                    11111111111111       1
1     11111111111111111111111111111111111111111111111111    X  1                11  1
1 X                  1    X                          11        1   1    11111  11   1
1     1111   11      1       11111111111111   X                1   X                1
1     1111   11  X   1                            1111         1       111111  11   1
1     1111           1  X  1  X  11111111111111111111111111111111111111111111  11   1
1111111111111111111111     1    11X                    X        1      1    111111111
1                 X        1            11                  1   1      1            1
1     11111111111111111111111111111111111111111111111111    1   1 X    1            1
1          X  1              1111   X               X       1   1           111111X 1
1 X           1   X      X   1111       X    1              1   1      1            1
1             1                              1            X 1          1            1
111111111111111       11111111111111111111111111111111111111111111111111         X  1
1     11      1       11   1            11       11                        11       1
1     11      1       1X  11                11                      1      11       1
1                     11   1       111111111111111111111111      111111111111       11
1      1111111111    1    1                              1      1       1111        11
1                     1   11     11111111111111     X     1      1                  1
1                     11   1     1           1     111    1      1  1 X 11      1   1
1 1111111111     X    1   11     1 11  11    1     111    1      1  1   11      1   1
111                   1    111   1   X       1    X       1      1  1           1   1
1 11                  1   111          1     1   1               1      X   11111   1
1         1111111111111  X           111     1   1      111      1               X  1
1   11          1     111111111111111111111111   1   X  111      111111111111       1
1   11     X    1               11        X      1      111       X    111          1
1               1      X                         1              11            1     1
1111111111111111111111111111111111111111111111111111111111111111111111111111111111111