11111111111
10eD0e00001
10010000001
111111111D1
10000000001
11110111111
10000000001
10000N0e001
11000001111
11111111111