11111111111
100D0000001
10010000001
111111111D1
10000000001
1111D111111
10000000001
10000N00001
11000001111
11111111111