NO textures/woo1d.png     
EA textures/mossy.png
SO textures/pillar.png
F 0,48,8


C 232,176,202
WE textures/greystone.png


1111111111111111111111111
1000000000110000000000001
         1011000001110000000000001
10010000000000000000000011111111
111111111011000001110000000000001
100000000011000001110111111111111
11110111H11111011100
000010001
11110111111111011101010010001111
11111111111111111111111111111111
100 00000X000 00 H0000001000111
11111111H1111111111111    111111
10  0000000000 0110101001000111
11000001110101011111X000000W0111
11110111111111111111111111111111
1111111111
 
101111010001
11111111
1111111
111111111111


