NO textures/wood.png     
EA          textures/mossy.png    
SO textures/pillar.png


F 220,100,0
WE textures/greystone.png

C 225,30,100
111111111111111111
  1001
11  111111011111111111111111111111111111111111111
  W11111111011000001110000000000001
1000000I0001100  0001110111111111111
   11110111111111011100000H10001
11110111111111011101010010001
   11000000110101011100000010001
1000000000          0000001100000010001
1I0000000000000001101010010001
1111111110110X0001110000000000001
1000000000110000000000001
   1011000001110000000000001
1001000H000000000000000001
  111111111011000001110000000000001
10000000001100  0001110111111111111
   111101111111110111000000XX10001
11110111111111011101010010001
   11000000110101011100000010001
1000000000   X      0000001100000010001
10000000000000001101010010001
               110000011101010111110111100111
1111011111111111111111111111111111111111111
1110101
111111111111
111111111111