NO textures/wood.png     
EA          textures/mossy.png    
SO textures/pillar.png
F 220,100,0
WE textures/greystone.png
C 225,30,100
1111111111111
100         11
1111111    W  
111111111111