NO textures/wood.png     
EA          textures/mossy.png    
SO textures/pillar.png


F 220,100,0
WE textures/greystone.png

C 225,30,100
1111
10S1
1111
11110111
1110101
101111010001
11111111
1111111
111111111111