NO textures/woo1d.png     

EA          textures/mossy.png    
SO textures/pillar.png
F 220,100,0

C 225,30,100 
WE textures/greystone.png


1111111111111111111111111
1000000000110000000000001
         1011000001110000000000001
10010000000000000000000011111111
111111111011000001110000000000001
100000000011000001110111111111111
11110111111111011100000010001
11110111111111011101010010001111
1111111111111111111111111111111111
1000000000000000110000001000111
1111111111111111111111    111111
1000000000000000110101001000111
11000001110101011111011110W0111
11110111111111111111111111111111
1110101
 
101111010001
11111111
1111111
111111111111


