NO textures/wood.png     
EA          textures/mossy.png    
SO textures/pillar.png
F 220,100,0
WE textures/greystone.png
C 225,30,100


1111011111111111
11101111
101111010001
111   1111
11111111
111111111111