111111111111000000
1e0101000011000000
101D01000011000000
1100e1010111
11W000000011
110011000011
1000e1000011
110000000001
110000000001
110000000001
11000000001
1011D100001
111111