111111
100101
101001
110001
11W011
110011
100001
101001
110001
111111
