NO textures/wood.png     
EA textures/mossy.png    
SO textures/pillar.png
F 220,100,0
C 225,30,100
WE textures/greystone.png

111111
100101
1X1H01
1100X1
11W001
110011
100001
1011H1
1111111