111111
100101
101D01
110001
11W001
110011
100001
1011D1
111111