NO textures/wall_no.png     
EA textures/wall_ea.png    
     SO textures/wall_so.png
F 161,133,148
C 127,181,181      
WE textures/wall_we.png

1111111111
1        1
1        1
1    11111
1    1  X1
1  E 1   1
1     H  1
11111H1111
1        1
1  X     1
1111111111
