111111
1e0101
101D01
1100e1
11W001
110011
1000e1
1011D1
111111