111111
1e01e1
101D01
110001
11W001
110011
10e001
1011D1
111111