NO textures/wall_no.png     
EA textures/wall_ea.png    
SO textures/wall_so.png
F 161,133,148
C 127,181,181
WE textures/wall_we.png

1111111111
1001000011
1 1H000 01
1100000001
11E0 000 1
1100000011
1000000001
1011H00X01
1111111111