111111
100101
101001555
1100N1
111111
2222
4