NO textures/wall_no.png     
EA textures/wall_ea.png    
SO textures/wall_so.png
F 161,133,148
C 127,181,181
WE textures/wall_we.png

111111111111
1 X     1  1
11111H111111
11         1
11E        1
11      1  1
1111111H1111
1 X        1
111111111111