111111111111
1e0101000011
101D01000011
1100e1010111
11W000000011
110011000011
1000e1000011
110000000001
110000000001
110000000001
110000000011
1011D1000011
111111111111