NO textures/wood.png     
EA textures/mossy.png    
SO textures/pillar.png
F 220,100,0
C 225,30,100
WE textures/greystone.png

1111111111
1001000011
1X1H000X01
1100000001
11E00000X1
1100000011
1000000001
1011H00X01
1111111111